#52726363245581#76158#7#5#66287#12331#4#7#536#2677#686#3#47#46437#31243#681#8#1452688#4#8#8#8841##34T
71##5##7######411###4#35788#4#42##4##851161#428##13##61864##7###66#2###72#12432###2#5#1252153##683#8#
8#4#67##56372#8##71#8#2##8#5#7#74#6273###7#7###81#6#42#5##416#781#64#153#4##1#4418#31##2##3##44##8#73
2#657#785###72#88#2#4##786#4461#66##5#318##6167#81122###656###2##33#48##4632#7###66#83#288#87#6782#8#
#53##28##448#67#384#6615###8#7###88#6#1#3681##531##4#8##6##7238#18#85##41##7#5#31#88#33##8#4##2###674
25#132#656#27#66#8#5#3##274#67##5#1#8#28#4#######62#86734#7#6##32#4#682#73#7#828#2#76#7634#436455###8
7#3#6#4#2#####1#72351#188#66#7556#234#3#3718##315#524#####1#7#4#6464##2#8#361#3##66#1##1#3######26652
64788#4844#4366#4###72##12#75##5#4#5#3#26#8#552#823##278537#7542##5#421#22#8#4711#3#523#1#665321##1#6
5####52##6#7##38#118#7181###74#5335#2855#8#48##8###53#3##2####2#377#5####8#57#8#7574##212#4####53#2#1
7#74##3#81#12#4##6#46#7#77###182###23##5#563#788235#247##78#67#43###8#5#184#8315###738##4#2#355#18#32
21#4362#4###86#414#3#673#44#3#2#123#861#56##74####4#1#881#858###6#312#733#8#1#5#536#8#6#72151#1#2#68#
#2##1##76####112##78#6#84##415#57#55##26#6517#334#76#82#41##71#8873#4#8###7#15#16#5#3727####57#23##48
343#531#38##1###46#41###1743#858#37#74#38####27#85#4##24#715#23####656#6562###44##87##4#6454##33#42#1
#8#78#87#753274#3#4#65#48#7#8###31#15###4#47#6#7#3#143###2#6##4#385##636###6732#62#267#31##8##7#41##3
28#8#8#6##3#5#8#553##4#4#275888#7###6###1#5##3#2#82##4151##68#2#1#21#2#2#644###2#51##187#8#1838#8##52
5##717#15####6256#37#8###2##6#8#27#343#13#5#1431#1#45###541#5#7#11#2#5##65###4544#364###738##7##6472#
388##12#241#45###4#4#6782#8113#1#25##445#3464##2#182#752##833#11#7#74#773#4751####6#2#724#625#334####
##3#5#64##31##4738#31###56#8#7758#55#7##3####3718#2#83#447###48##21#2#1##73#1#14326#7#4#53#3#84##772#
6#1#672#5##152###287#227#23#5###44#828#763262#5#2#6#5##8#6#67#2686#81#6#5#5#226#6#65#45##26#24#5#3#25
8#64#2#2176##577#1#7#1###5#55135#83###15#6##63##1#324#35#44#24##8#67#42#84#23#7#22#1#2#48#584#15534#5
2#6#211##8#66##78##2#4#578#5###5#1#8251##6#6#6#77#7#4#2##4#44#87#86#5#47#74##1#25##5#17#72#2#62###1#7
1#2#1#17#142#62#8#83#8#2##2434##44##7##868#541##16#1#71#13#7#54##8#65##16#532324#2511#7#3#6##7#5136#8
5#84#7#6##2###678#5##4#524#4#83#7#148#78##7#8#27#3#8#1#33#5831#674##456#5#2#5###38##6#4#324725#1####1
71#7#8367511##7##442128##48###6#57#7##2##81#6#3#17#4#81#1#3#8#2#7#144#8#1#6#2#7#1#48#71#3###6#311714#
2#35#4######4463######226#87#111#8##513#46#27#477#786#2#11#27#4725###3115#2#4#1#8#5#37#3#524#5###3#26
5#3#82#4787#7#7#826143#7#43#28#6#32#8##28###3#8#343###84#84#15#6##4748#####72#38646#7#4538#676876###3
5#7#6#54##4436##8####27##3#27##33#3#24##46#47##1#5#6224#46#5#4#6658#6#323#15#66#8#7#742###6###3#74#33
3#6#7##6#23#6#727#438#6#87##147#2#62#326#6#6#5456#85###2#7#1682####1##7#418#67#2##28#1#4856136#6#41#5
3#8#71#63#3##16##8##2#586#426#28###48#1#47#34#2#341#75#1#17##8#385#65354##6#1#5677#48#5#8#7##5#6#7#15
2#3#####27#638#4475372###22#86#71#64#53##883#718#8#5#3864#17#15##785#8#3#426#35##82#8#41##37#276#4#3#
4#4652#21#55##72#7#6#6#758#7#21#231###721#6#64#42#3586##85#33#47#6#6#3##11#1#3#3##5#51#5671#55#5#343#
5#8##3##8#7#777#58#68#83##767#12##8##3##8#5###5#65#1#521#75#3##17#736#553#25#2#45#2##1##4##71###87#42
6275#4572#22##31#32###1###4#8####57236553#763156#26#25#73#1#351#3#8#4#4#47#3#41#2#81#2885#72#4#26#4#2
6##77###82#817#8##1#6314#88#37687#######1##3#4#1#3#33#83#367##6#7585#78##71#1#7272#76###6#3#33#5#457#
78#5#844#35##4#74#6#7###83#1#2##6#17367#26###32#18#7#1#54###8#64#6#7#6#22#3377#5#6#6#64#34#1#237###61
#73##4#45#13#66#8#255#7#1#486#2#575#8#4###863#558#88#8#1#61431#67###888#6###3#22###1#2#66#1314##668#8
57#825##2##81#83#71##68#7#7#313#1##7##35416#3##2#3#7#3#523#6##7#78#86#1#37752#8#8685#165#48#8##67#6#1
###6##43215#87#14#5678#87#6###57#57631####5#714##85161#2###1#215#143#1#38####43#7####1##4#26#664#73#4
7848##8###4#6#26#6###7#8##6832#6##5##16634#5##133#3##14#545733#36#5#87#8#532#6##57617##831#25#6#55#48
1###725#2##61#4#52#713#165#7#4#274#184###1#7####68#433#24#7#8#5#12#2#6#283#6#138####5132#21#3#65#2#6#
8#4#5##54213##1#5#82##8##22#46###58#6##313#83#53#42###41###5#533#5#276##1#648##63628####21#86##8#5#26
4#53867#6####18#8#4##24#7#747#428#2#468#5#3#113#1#753#6###346#4#22#4#46#15##818####5#46#2#55#848#6#3#
5#6###37##2412#58#387#568#5##23###3#5#5#118#2#3#3###7#83#66#6#88#655##3##81##5#441#3#6#725#3#5##52747
6##365#2574###81####7#3#13#741#6186##22##6#86#6#783#6#4#22##37#25###1852##77#4#6#64347#2#5#4#8##2##3#
3785#1##5##7141#5#6#7#6##7#6#5#6###228#556#1#157#1##2#7#8#734#8#745##5#42##17#62#####1#78#68#677##875
1###7225#237##4#37434#53#5#21#64#377##8#5#248##185#42#785#4##677##13517##523#53#1556#47#8##3#8#542###
#473###5#3##4#7#1####6#2#15#8#6#27#7#41#8#3#5#85#3#7#6##8#5388#732#5###667##41#61##31#6#3541#52##4558
77#48216#7383#3#5#22#8385#4#5#622#1#62#481#27##38#41#414#13#4##4#1#2#288##52#13#356#65#1####6#64####5
8#######76##5#7#844#22##1#6766#1#4278#6##356#87#65#246#58###7#46#3#6#4##417#1#71#6#1#427811#364#357#8
48#4462#4#833#28#1#51#2#75#1#73#21###33577##5#51#31###5#3168#76#52#7#5#18#286#8#58#5###3##68#2#77#547
#35#2#31#16##3#332#6#282#71#2#771#8666#5##1262#613#14246#5#6#4#75###4583###1##1#1#88585#71#74#28####3
5#1#88#3#1#5746###3#66#4##1#4#5#7#2#1#841#6##47###75###57##5#5#8###37##68#7#471#7#7#6#467#4#542#4#654
5167##4656#5#2##5#241#76377#7365#246#1#6#28###474#6#737#1652#8#66#75#####6143##434#53##4#44###6#165#1
1##362#8##61#16123##28###7#64#1##5##763##7#2####6#74#7#8#5##3#71#41#5##753###664##43#65254#5158##7#4#
7#44#3#8#72##5###25#8#317#8##3#672#21#5#52#23#878##2#7828#44265#24#38436##118##675##17#8##48###165#58
#27##3#3#2#227#6#8#54#6#672716#3##8#1#345###45#1#842#3##6##7##7#2#6#3##44#1#515##3547#126#6##143##8#4
47#523#41##2##44#4#8#34######364123#26###4#5#5#647##65##5266###24#84##1#6#77##585###8#7#4#1#33##12378
#4#6##7#2323#2#333#14#855431##5##2#2#8#55588882###777#38###85#72#8#6746#1##752##6716#686#43##1#47#2#2
45#24222####66#7##65#3#####251#72#7686#5##6#8###4#5#71#88386#63##668#6##452##341###2##5#24#632#7#6##5
#11#2##5686##514761#47#2475##218##6####187#343768#73#62#7#3#53#845###587##255#2#64#471#57#82##24#7685
11#7#48###11####3#25#855##564#1#314#354##53#8#7#5#2###37#84#1#####1375##71#4##8#5#12#3##7##26###12###
5#3316#553#65111###25#1#23##445#4##83#6#6#31#35##131#7#1#2#513#1821##4873##4458#3#3##31#133#164#7#565
8#2#1#24###4###67#2#6#7##526#7#21#14#67#57#27#536##657#4#2#4##75###52###7#8####455##3#1###3#5#5#222#2
52#7644#288#164#4#2#4#54#2#42#8#41#7#7#7#36#15##76#2#2#45##5#22#2658#36#1#7753#4#6637#25221#3#8#2##43
1#58###26#838#1#6#1364#7#74#8237#3#4#8#874#46##6#54#448#8848#1#74##81#135#1##3#6#3#8#6###5#4#283#844#
62#386#3#83##41#3#6#7#42##35##2#31#2#2#5##56#7412#61##53##5#84##631#73#2###7#6#52#76#1#31#488##65#7##
2#11#7#12##164#542#53#5#674#322#8#83#841#31##3##77#64##5#8##1#231#51#1#64#6224##52#61377#32#84##8#71#
6#8##21#664#5##7#15#1#3#3#78#2#64#7#22##14#421#6#61#78#4#7218####62###3#263##743#63##4###4#7#28#83#47
17##85####1#852###52##2#35##64#6#18#7#516###7#861#82#642##2##52884###436###4#7#77#24#16772#75#83#3##1
#8164###477###41#4#7#37#5#854##62#75#77#75#75#4#6#2#8###331###2##45#82#62844652##22#1#####61#15#148#5
##8#47#61##488#52243#2#62#7###4#76#166#6#213#675#36#4#684##4#275#3#48#7#5##7###475#828861##8##66#6#65
#61###73##64#24#####33#6##47377##2##3#55##8#88#3#1#6482#8#2781#6#42#825#3#4#6226##1#5#5#85#413#288#7#
41#2727#823#4#3#824#1##188##6#83#583#8#733#7#8#8#2#5#4#73#2#5#12##46##55#28#3#7#2115#466#117#5#4##136
###6#5#53##7641#1#1#324#####35#52##7583#3#22878##46####6#61##52#71#3#7#4#1#26##57##23#3#3##4#55##2#6#
8623###3#722#1#77#1###3151#74#56#3#3#2#3832#2#436#75#355##88#4###38577#327#3#187#45#3##7387###275237#
4#8#3124#4###2#3##1556###212#75#2137##26#1#658##212#36##35#3#67#31#1###4#3#18#1#14#613#7##46#68#6##42
7#3#6####4556#8853#2#6573#7#32#17###513#3##8#6#8####8#81#1674#12##2#75118#75#58#8#46#718#16#78#44###4
32#42#725###4#6#7#88#4##8#8#6#5#875#1##6721#1128283457#76#8#2#5#22585#2#6#1#14#7121#3###63##6#68#7#27
#51#18##124#455#87#28#4#16#14#11##2##537##4#4########77#886#4#653#8##4###71#3#5##1#42186#117##3#418#2
5#56#824##56###5##5#5#35#62#7#3#5#4346##7#52#15584231###4##71####6#6786#55#426474##7###4###5382#3#1#4
874#1##5#6#538#4873#1##751##353843##4#8#73#52#7#1###2335##74#13357#1##528#6#5###1326#4#7558##5#51#1#3
#1#838#644###53#2#4#886#5#86#####562#2375#74##65#573###4#16#56#4#6#37#7##32#3#32#3##642##1#1##13#15#8
#751#6#3#3735#567#76##6#62#42771##4#16#6#4#766#725#565#88#12#35#854#57#135##78#41#561#8#88#5741#31#41
15###88#2###7###86#14#88#3###4#64#6###1268#1#33###3##72#5##48##33#3#4#41#856#38#6#6##17#3######61#84#
1#1161#8116#5482#81##2#5#73325#1##345#8##4#61##737854#5#536#2346##6#16#5#1##71#734763#8#78#35833##5##
5###6#66##2####5##3765#85##2#6#417##131##51#47#6##5###85##1##6#7#68#4#46#7#74#75#####28#2#48##5#712##
8853#78#8#1526#151##7#21#22#4#17#353###663#13#622#8#747#6#887###87#62#6#16#4##5##83452#38#6#42#73##1#
8##133#154###7#5#54#28#42#4184#4#7##523#8#1#51##3#611##575##1##74#37##88#3#557##56#4#3#5#14##2#6#7238
77######6#65#32#62#57#43##6##68#67317##81#13#8525####725#41#768#3#1#11#8#86##8#77##71#87##3357#22#2#8
#74685#5784#1#22#524###478#72#585####336##2#8####16784#3##63##6#5#5#2#67#6###716#66#4#8#25#2##2#52#22
7####857##3177#73##74#3##474#####7671##7671#3561#4#8##6277##1#3#7#7#884#486#5#####133#6##147#841#33#6
7#537###14###26#778#7#118#6#6#2454##342#7#7##3#44#5822###6#26#81#35#6#44##665848##8#3#254##243#2#2#74
138#822#2##63#75##3#66#7##35681###31##46#517#71#5#1##652#811#2#571#121#443#####7581###5#244#2#55#66#1
6#2##4#84275#2#64#24#737#6#####7834#14#12##4#4#77###64#8#5#4#41#7##2#77###22331####862##8#6#85####681
#543#583##8#74#6###47##375#45824##1#1#7#47#172#5#267##35#7#15#43#8824##5458###532468#5#18#38#278#8##2
53###7###7482#141#2#227##28#6###276#5542#46####111#7#78#515#357#37#8#583###11#######67#2#27#65#613#84
##261#5663#3#1#8#62#5###42#66#18#1#62#8###7#751###23#1#86#71##33#8##64##211#44561442#73#1#7#2####57#3
761#658#####7173#3##68717#54#8#341#1#731#83#8#658#7###4#65#3#3#43#888#632#4#6#2##1##1#26438#1##23#736
3##2###848##6#8#1327#####24#6411##42#3##77#43#8#2726#742##78#75#8#5#5#4#33#72#411#3652#1####515#31##4
12185187#52211##5#2#8687#4#63#6#7#2##2#54##6#8#6####81#53#2#4#3#4#33#241#723##3#5#6#5#7#4767##4##676#
B#1#7#8#74#8#4187#175##476#5#744365#253#5625644347475###822#6677787#83#64#5#116#135#47586##7235466#64
